by the same token	bằng những bằng chứng tương tự như thế
in like manner	theo cách tương tự
in the same way	theo cách giống như thế
in similar fashion	theo cách tương tự
likewise	tương tự
similarly	tương tự
and	và
also	cũng
besides	ngoài ra
first	thứ nhất
second	thứ hai
third	thứ ba
in addition	thêm vào đó
in the first place	ở nơi thứ nhất
in the second place	ở nơi thứ hai
in the third place	ở nơi thứ ba
furthermore	xa hơn nữa
moreover	thêm vào đó
to begin with	bắt đầu với
next	tiếp theo
finally	cuối cùng
accordingly	theo như
and so	và vì thế
as a result	kết quả là
consequently	do đó
for this reason	vì lý do này nên
hence	vì vậy
so	vì vậy
therefore	vì vậy
thus	vì vậy
then	sau đó
but	nhưng
however	tuy nhiên
nevertheless	tuy nhiên
in contrast	đối lập với
on the contrary	đối lập với
instead	thay vì
on the other hand	mặt khác
still	vẫn
and so	và vì thế
after all	sau tất cả
at last	cuối cùng
finally	cuối cùng
in brief	nói chung
in closing	tóm lại
in conclusion	kết luận
on the whole	nói chung
to conclude	để kết luận
to summarize	tóm lại
in other words	nói cách khác
in short	nói ngắn gọn
in simpler terms	nói theo một cách đơn giản hơn
that is	đó là
to put it differently	nói khác đi
to repeat	để nhắc lại
above	phía trên
alongside	dọc
beneath	ngay phía dưới
beyond	phía ngoài
farther along	xa hơn
in back	phía sau
in front	phía trước
nearby	gần
on top of	trên đỉnh của
to the left	về phía bên trái
to the right	về phía bên phải
under	phía dưới
upon	phía trên
as an example	ví dụ
for example	ví dụ
for instance	ví dụ
specifically	ví dụ
thus	thật ra
to illustrate	minh hoạ
in fact	thực tế là
indeed	thật sự là
no	không
yes	có
especially	đặc biệt là
in other words	nói cách khác
in short	nói ngắn gọn lại thì
in simpler terms	nói theo một cách đơn giản hơn
that is	đó là
to put it differently	nói khác đi thì
to repeat	để nhắc lại
afterward	về sau
at the same time	cùng thời điểm
currently	hiện tại
earlier	sớm hơn
formerly	trước đó
immediately	ngay lập tức
in the future	trong tương lai
in the meantime	trong khi chờ đợi
in the past	trong quá khứ
later	muộn hơn
meanwhile	trong khi đó
previously	trước đó
simultaneously	đồng thời
subsequently	sau đó
then	sau đó
until now	cho đến bây giờ